NO ./assets/textures/north.png
NO ./assets/textures/north.png
SO ./assets/textures/south.png
WE ./assets/textures/west.png
EA ./assets/textures/east.png

F 120,120,120
C 200,200,200

1111
1N01
1001
1111
