NO ./assets/textures/north.png
SO ./assets/textures/south.png
WE ./assets/textures/west.png

F 80,80,80
C 150,150,200

1111
1N01
1001
1111
