NO ./assets/textures/north.png
SO ./assets/textures/does_not_exist.png
WE ./assets/textures/west.png
EA ./assets/textures/east.png

F 70,70,70
C 120,120,160

11111
1N001
10001
10001
11111
