NO ./assets/textures/north.png
SO ./assets/textures/south.png
WE ./assets/textures/west.png
EA ./assets/textures/east.png

F 40,40,40
C 220,220,220

11111
1N0S1
10001
10001
11111
