NO ./assets/textures/north.png
SO ./assets/textures/south.png
WE ./assets/textures/west.png
EA ./assets/textures/east.png

F 60,60,60
C 200,200,200

11111
1N001
10000
10001
11111
