NO ./assets/textures/north.png
SO ./assets/textures/south.png
WE ./assets/textures/west.png
EA ./assets/textures/east.png

F 70,70,70
C 200,240,240

11111
1N0X1
10001
10001
11111
