NO ./assets/textures/north.png
SO ./assets/textures/south.png
WE ./assets/textures/west.png
EA ./assets/textures/east.png

SP M ./assets/sprites/enemy.png 12 1
SP m ./assets/sprites/enemy_dead.png 4 2
SP H ./assets/sprites/health.png 6 3
SP C ./assets/sprites/coin.png 15 4
SP W ./assets/sprites/weapon_b.png 12 5
SP w ./assets/sprites/attack.png 7 6

FT ./assets/textures/floor.png
CT ./assets/textures/sky.png
DR ./assets/textures/door.png
MN ./assets/textures/menu.png
ST ./assets/textures/info_game.png
WN ./assets/textures/win.png
LS ./assets/textures/lose.png

F 50,50,50
C 135,206,235


1111111111111111111111111111111111111111111
1111111111111111111111111111111111111111111
1111111111111111111111111111111111111111111
111110M0000M001100M0M00M00M00M000M00111111
111110110000111000M0000000000000000M0111111
11111001000M00M00M00M0000000M0000000111111
11111111110D1111M0M000011M000M0M00M0111111
111110M00000001M00M00001100N0M000M00111111
1111111101111100111111111M0M00000M00111111
11111H0M01100M0M00M0M000M00M0M0000M1111111
11111110D11001010101M1010111M00M000M0M11111
11111M0M00001M0H0M00100M1M0M010M0M10111111
11111M0M000010M0M0M0100010M0M101M0M0111111
111110M000M01M0000M0D00010M00101M0M0111111
111111111111M00M0001111100H010100M00111111
11111M00M00M0MH0M000M1M0M00M0M10M000111111
11111M0M00M0M0M000M001M00M000M10M0M0111111
1111100M0M000M0M0D11100M0M00001M001M111111
11111M0M000M00M000M0M00M0M0M00M10M0M111111
11111011111101111111111111101110M110111111
111110M0M00M00M0M00M000M001M10M00M00111111
11111M00HH000M000M0M0M000M1D1M00M000111111
11111M0M00M0M00M0M00M0M0M010100H0M00111111
1111111111D111111111111110111M1D1M0M111111
11111M0M00M0M00M000M0M0M00M000M0M001M111111
11111M00M000M00M0M000M0000M00M000M00M111111
11111M0M00M000M00M0M0M0HM0M000M00M000111111
11111001M0M00M00M00M0M00M00M00M0M00M0111111
1111111111011111111M111111M1M1111110D111111
11111M0M00M001000M000M0M00M00M0M00M00111111
11111M00M0M00010M0HM00M00M00M000M0M00111111
11111M000M0M001M0M00M00M0M00M0M000M0M111111
11111M0M000M001M000M00M00M00M00M0M000111111
11111110D1111101111111111111111111111111111
11111M00M0M00M01M000M00M0M00M00M0M0M0111111
11111M0M000M0001M0M000M00M00M000M00M0111111
11111M00M0M00M01M00M0M00M00M0M000M000111111
11111M0M000M0001M00HM00M0M00M00M0M0M0111111
11111M00M0M00M010M0M00M00M00M000M0000111111
11111M0M00CM00001M000M0M00M00M0M00M00111111
11111M00M0M0M0M01M0M000M00M00M00M000M111111
11111M0M000M000M1M00M0M00M0M00M0M00M0111111
11111111111111111111111111111111111111111111
11111111111111111111111111111111111111111111
11111111111111111111111111111111111111111111