NO ./assets/textures/north.png
SO ./assets/textures/south.png
WE ./assets/textures/west.png
EA ./assets/textures/east.png

SP M ./assets/sprites/enemy.png 12 1
SP m ./assets/sprites/enemy_dead.png 4 2
SP H ./assets/sprites/health.png 6 3
SP C ./assets/sprites/coin.png 15 4
SP W ./assets/sprites/weapon_b.png 12 5
SP w ./assets/sprites/attack.png 7 6

FT ./assets/textures/floor.png
CT ./assets/textures/sky.png
DR ./assets/textures/door.png
MN ./assets/textures/menu.png
ST ./assets/textures/info_game.png
WN ./assets/textures/win.png
LS ./assets/textures/lose.png

F 50,50,50
C 135,206,235

11111111111111111111111111111111111
11111111111111111111111111111111111
11111111111111111111111111111111111
11111000000001100000M00000000011111
1111101100001110000MMM0000000011111
1111100100000000000M000000000011111
11111111110D11110M0000110M000M011111
111110000000N0100000001100000011111
11111111011111001111111110000011111
11111H00011000M00MM00000000001D0H111
11111110D110010101010101110000M1111
11111000000010000000100010000101111
11111M00000010M0MM0100010M0H101111
111110000000100H0000D00010000101111
11111111111100000001111100H0101111
11111000M00000000000100000000101111
1111100000MM000000M00100000000101111
1111100M00000000D111000000001M01111
11111000000M00000000000000000101111
111110111111011111111111111011101111
1111100M000000000H0000001010000111
11111000000MM00MM0000001D1000011111
1H0D00000000MM0000000010100H0111111
1111111111D1111111111111101111D1111
11111M0V010000MM0MM0000MH000M0111111
111110MM010M00M0000M00M0000000001111
111CD0M0MMMM0000000000M00000000M111
11111111111111111111111111111111111
11111111111111111111111111111111111
11111111111111111111111111111111111