NO ./assets/textures/north.png
SO ./assets/textures/south.png
WE ./assets/textures/west.png
EA ./assets/textures/east.png

SP M ./assets/sprites/enemy.png 12 1
SP m ./assets/sprites/enemy_dead.png 4 2
SP H ./assets/sprites/health.png 6 3
SP C ./assets/sprites/coin.png 15 4
SP W ./assets/sprites/weapon_b.png 12 5
SP w ./assets/sprites/attack.png 7 6

FT ./assets/textures/floor.png
CT ./assets/textures/sky.png
DR ./assets/textures/door.png
MN ./assets/textures/menu.png

F 50,50,50
C 135,206,235

111111111111111111111111111111
100000000000000000000000001111
100000000000000000000000000011
100000000000000000000000001111
100000100000100000000000011111
100H00100010100000000000001111
100000D00010D00000000000011111
100000100010100H00000000001111
100000111D1110000000000D111111
100000000000000000000000001111
10000000M000000000000000001111
100000100000000000100000011111
100001000N00000000010000001111
100001000000000000010000001111
100000000000M00000000000001111
10000000000M00000000M000011111
100000011111D11111D11111001111
100H00100000000010000000001111
100000D00000C00000D00000000111
100000010000000001000000001111
100000011111D11110D11111001111
100000000000M00000000000001111
100000000000000000000000011111
111111111111111111111111111111