NO ./assets/textures/north.png
SO ./assets/textures/south.png
WE ./assets/textures/west.png
EA ./assets/textures/east.png

SP M ./assets/sprites/enemy.png 12 1
SP m ./assets/sprites/enemy_dead.png 4 2
SP H ./assets/sprites/health.png 6 3
SP C ./assets/sprites/coin.png 15 4
SP W ./assets/sprites/weapon_b.png 12 5
SP w ./assets/sprites/attack.png 7 6

FT ./assets/textures/floor.png
CT ./assets/textures/ceiling.png
DR ./assets/textures/door.png
MN ./assets/textures/menu.png
ST ./assets/textures/info_game.png
WN ./assets/textures/win.png
LS ./assets/textures/lose.png

F 50,50,50
C 135,206,235

111111111111111111111111111111111111
111111111111111111111111111111111111
111111111111111111111111111111111111
11111000000001100000M000000M00011111
1111101100001110000MMM00000M00011111
1111100100000000000M0000000M00011111
11111111111D11110M0000110M000M011111
111110000000N010000000110000M0011111
1111111101111100111111111000M1111111
11111H00011000M00MM0000000000D00H111
11111111D1100101010101011100M11M1111
1111100000001000000010001000M0101111
11111M00000010M0MM011001MMM0MH101111
111110000000100H0000D0001000M0101111
1111111111111000000111110MM0H0101111
11111000M00000000000100M000000101111
1111100000MM000000M00100000000101111
1111100M000000000111000000M001M01111
11111000000M000000000000M00000101111
111110111111011111111111111011101111
1111100M000000000H0000001010MM000111
11111000000MM00MM00000011100M0011111
1H0D00000000MM00000M00011100H0111111
1111111111D111111MMM1111110111101111
11111M0V010000MM0MM0000MH000M0111111
111110MM010M00M00M00M00M000000000111
11C0D0M0MMMM0000000000M0M000000C0111
111111111111111111111111111111111111
111111111111111111111111111111111111
111111111111111111111111111111111111