NO ./assets/textures/north.png
SO ./assets/textures/south.png
WE ./assets/textures/west.png
EA ./assets/textures/east.png

SP M ./assets/sprites/enemy.png 12 1
SP m ./assets/sprites/enemy_dead.png 4 2
SP H ./assets/sprites/health.png 6 3
SP C ./assets/sprites/coin.png 15 4
SP W ./assets/sprites/weapon_b.png 12 5
SP w ./assets/sprites/attack.png 7 6

FT ./assets/textures/floor.png
CT ./assets/textures/ceiling.png
DR ./assets/textures/door.png
MN ./assets/textures/menu.png
ST ./assets/textures/info_game.png
WN ./assets/textures/win.png
LS ./assets/textures/lose.png

F 121,110,31
C 135,206,222

111111111111111111111111111111
1000000M0000000000000000001111
1000MM0000000M000000M000000011
100000000M0000000MM00000001111
100000100000100000000000011111
100H001M001010000000M000001111
100000D00010D0N000000000011111
100000100010100H00M00000001111
100000111D11100000000000111111
10000M000MM0000000000000000111
10000000M0001111M0000000000111
100000M00000DMM101000011001111
1000010000001CM100010000001111
10MM01000000111100001000000111
100000000000M00000000000001111
10000000000M00000000M000011111
1000000110001D1111000001001111
100H00100000000010000000001111
100000000000M0M000000000000111
100M0001000000000100M000000111
100000011111D11110D11111001111
1111000M0000M00000000000001111
1CMD000M0000000000000000011111
111111111111111111111111111111