NO ./maps/textures/north.png
SO ./maps/textures/south.png
WE ./maps/textures/west.png
EA ./maps/textures/east.png

F 220,100,0
C 225,30,0

11111111111111111111111111111
10000000000000000000000000001
10000000000000000000000000001
10000000000000000000000000001
1000000011111D111111000000001
10000000100000000001000000001
10000000100000000001000000001
10000000100000000001000000001
1000000010000000000D000000001
10000000100000000001000000001
10000000100000000001000000001
10000000111111111111111111111
10000000000000000000000000001
1000000000111D1000000000000011
1000000000D000D00000000000001
100000000011D1100000000000001
11000000000000000000000000001
11111111D11111111111111111111
10000000000000000000000000001
10000000000000000000000000001
10000000000000000000000000001
1000000011111D111111111111111
10000000100000000000000001111
10000000100000000000000000011
10000000100000000000000000011
1N000000100000000000000000001
10000000100000000000000000001
11111111111111111111111111111