NO ./maps/textures/north.png
SO ./maps/textures/south.png
WE ./maps/textures/west.png
EA ./maps/textures/east.png
SP M ./maps/textures/enemy.png 12 1
SP m ./maps/textures/enemy_dead.png 4 2
SP H ./maps/textures/health.png 6 3
SP C ./maps/textures/coin.png 15 4
SP W ./maps/textures/weapon_b.png 12 5
SP w ./maps/textures/attack.png 7 6

FT ./maps/textures/floor.png
CT ./maps/textures/sky.png
DR ./maps/textures/door.png
MN ./maps/textures/menu.png

F 50,50,50
C 135,206,235

1111111111111111111111111111
10000000000000000000000000111
100000000000000000000000000011
10000000000000000000000000111
10000010000010000000000001111
100H00100010100000000000001
100000D00010D000000000000111
100000100010100H000000000011
100000111D1110000000000D111
1000000000000000000000000011
10000000M000000000000000001
100000100000000000100000011
100001000N00000000010000001
1000010000000000000100000011
100000000000M000000000000011
10000000000M00000000M000011
100000011111D11111D111110011
100H001000000000100000000011
100000D00000C00000D000000001
1000000100000000010000000011
100000011111D11110D11111001
100000000000M00000000000001
100000000000000000000000011
1111111111111111111111111111