NO ./maps/textures/north.png
SO ./maps/textures/south.png
WE ./maps/textures/west.png
EA ./maps/textures/east.png

F 220,120,0
C 115,150,0

111111111111111111111111111111111111111111111111111111111111111
1000000000000000000000000000000000000000000000000000000000000011
1000000000000000000000000000000000000000000000000000000000000011
1000000000000000000000000000000000000000000000000000000000000011
1000000000000000000000000000000000000000000000000000000000000011
1000000000000000000000000000000000000000000000000000000000000011
1000000000000000000000000000000000000000000000000000000000000011
100000000000000000111111111111111111111111111111111111111111111
100000000000000000000000000001
100000000000000111111111111111
100000000000000000111111
1000000000000000000000011111
1000000000000000000000000001
1000000000000000000000001111
10001111111111111111111111
10000000000000000000000001
10N00000000000000000011111
1000000000000000000001
1000000000001111111111
1000000000000001111111111111111111111111
1000000000000000000000000000000000000011
1000000000000000000000000000000000000011
1000000000000000000000000000000000000011
1000000000000000000000000000000000000011
1000000000000000000000000000000000000011
1000000000000000000000000000000000000011
1000000000000000000000000000000000000011
1000000000000000000000000000000000000011
1000000000000000000000000000000000000011111111111111111111111111
1000000000000000000000000000000000000000000000000000000000000011
1000000000000000001111111111111111111111111111111111111111111111
100000000000000000000000000001
100000000000000111111111111111
100000000000000000111111
1000000000000000000000011111
1000000000000000000000000001
1000000000000000000000001111
10001111111111111111111111
10000000000000000000000001
10000000000000000000011111
1000000000000000000001
1000000000001111111111
1000000000000001
1111111111111111