NO ./maps/textures/north.png
SO ./maps/textures/south.png
WE ./maps/textures/west.png
EA ./maps/textures/east.png

F 220,100,0
C 225,30,0

111111111
1S0011101
10000D001
100011111
111111111
