NO ./maps/textures/north.png
SO ./maps/textures/south.png
WE ./maps/textures/west.png
EA ./maps/textures/east.png

F 220,120,0
C 115,150,0

111111111111111111111111111111
100000000000000000000000000001
100000000000000000000000000001
100000000000000000000000000001
100000000000000000000000000001
1000000000000N0000000000000001
100000000000000000000000000001
100000000000000000000000000001
100000000000000000000000000001
100000000000000000000000000001
111111111111111111111111111111