NO ./maps/textures/north.png
SO ./maps/textures/south.png
WE ./maps/textures/west.png
EA ./maps/textures/east.png

FT ./maps/textures/floor.png
CT ./maps/textures/sky.png

F 220,100,0
C 225,30,0

111111111111111111111
100000000000000000001
1000110000000N0010001
100000000000000000001
100000000110000000001
100000000110000000001
100000000000000100001
100000110000000000001
100000000000000000001
111111111111111111111
