NO ./maps/textures/north.png
SO ./maps/textures/south.png
WE ./maps/textures/west.png
EA ./maps/textures/east.png
SP ./maps/textures/fire.png 8

F 50,50,50
C 135,206,235

1111111111111111
1000000000000001
1000P00000P00001
1000000000000001
1000000110000001
1000000110000001
1000P00000P00001
1000000000000001
10000000N0000001
1111111111111111
