NO ./maps/textures/north.png
SO ./maps/textures/south.png
WE ./maps/textures/west.png
EA ./maps/textures/east.png

MN ./maps/textures/menu.png
FT ./maps/textures/floor.png
CT ./maps/textures/sky.png

F 220,100,0
C 225,30,0

11111111111111111111111111111111111111
111111111000000000000000S0000000000111
11100000000000000000000000000000000011
11100000000000000000000000000000000011
11100000000000000000000000000000000011
11100000000000000000000000000000000011
11100000000000000000000000000000000011
11100000000000000000000000000000000011
11100000000000000000000000000000000011
11100000000000000000000000000000000011
11100000000000000000000000000000000011
11100000000000000000000000000000000011
11100000000000000000000000000000000011
11100000000000000000000000000000000011
11100000000000000000000000000000000011
11100000000000000000000000000000000011
11100000000000000000000000000000000011
11111111111111110000001111111111111111
11100000000000000000000000000000000011
11100000000000000000000000000000000011
11100000000000000000000000000000000011
11100000000000000000000000000000000011
11100000000000000000000000000000000011
11100000000000000000000000000000000011
11100000000000000000000000000000000011
11100000000000000000000000000000000011
11100000000000000000000000000000000011
11100000000000000000000000000000000011
11111111111111111111111111111111111111