NO ./maps/textures/north.png
SO ./maps/textures/south.png
WE ./maps/textures/west.png
EA ./maps/textures/east.png

F 220,100,0
C 225,30,0

11111
10X01
11111
