NO ./maps/textures/north.png
SO ./maps/textures/south.png
WE ./maps/textures/west.png
EA ./maps/textures/east.png
SP M ./maps/textures/enemy.png 12 1 0
SP H ./maps/textures/health.png 6 2 0
SP C ./maps/textures/coin.png 15 3 0
SP W ./maps/textures/weapon.png 14 0 4
SP P ./maps/textures/attack.png 7 0 5
SP D ./maps/textures/enemy_dead.png 4 0 6

F 50,50,50
C 135,206,235

1111111111111111
1000000000000001
1000M00000H00001
1000000000000001
11110000M0000001
1CM0000000000001
1111H00000M00001
1000000000000001
10000000N0000001
1111111111111111
