NO ./maps/textures/north.png
SO ./maps/textures/south.png
WE ./maps/textures/west.png
EA ./maps/textures/east.png

FT ./maps/textures/floor.png
CT ./maps/textures/sky.png

F 110,100,0
C 125,120,0

111          1111111111111111
101          1000000000000001    
101          1011111111111101    
101          101          101     
1011111111111101          101     
10000D0000000001          1D1
1011111111111101          101     
101          101          101     
101          101          101     
101          101          101     
101          101          101
101          101          101 
10111111111111011111111111101
1000000D000000000000000000001
11111111011111111111111111101
       101                101
       101                101
       101                101
       101                101
       101                101
       101                101
       1011111111111111111101
       100000000000000D0000N1
       1D111111111111111111D1
       101                101
       101                101
       101                101
       101                101
       101                101
       101                101
       1011111111111111111101
       100000000000000D000001
       1111111111111111111111