NO ./maps/textures/north.png
SO ./maps/textures/south.png
WE ./maps/textures/west.png
EA ./maps/textures/east.png

FT ./maps/textures/floor.png
CT ./maps/textures/sky.png

F 220,100,0
C 225,30,0

1111111111111111
1000100000100001
1000100000100001
1000100000100001
1000000000000001
1000100000100001
1000100S00100001
1000100000100001
1111111111111111