NO ./maps/textures/north.png
SO ./maps/textures/south.png
WE ./maps/textures/west.png
EA ./maps/textures/east.png

FT ./maps/textures/floor.png
CT ./maps/textures/sky.png

F 220,100,0
C 225,30,0

 
1111111111111111111111111
1000001000001000001000001
1000001000001000001000001
1000001000001000001000001
1000001000001000001000001
100000D000001000001000001
1000001000001000001000001
1000001000001000001000001
101111111D111111D11111101
1000001100001000001000001
100000101000D000001000001
1000001001001000001000001
10000D000101000001000001
1000001001001000001000001
1000001010001000001000001
100000110000100000D000001
1000111111D11111D11110001
1000001000001000001000001
100000100000D000001000001
1000001000001000001000001
1000001000001000001000001
1000000001111100000000001
100W00100000100000D000001
1000001000001000001000001
1000011111111111111111111
1000011111111111111111111
1000011111111111111111111
1000011111111111111111111
1000011111111111111111111
1000011111111111111111111
1000011111111111111111111
1000011111111111111111111
1000011111111111111111111
1000011111111111111111111
1000011111111111111111111
1000011111111111111111111
1000011111111111111111111
1000011111111111111111111
1000011111111111111111111
1000011111111111111111111
1000011111111111111111111
1000011111111111111111111
1000011111111111111111111
1000011111111111111111111
1000011111111111111111111
1000011111111111111111111
1000011111111111111111111
1000011111111111111111111
1000011111111111111111111
1000011111111111111111111
1000011111111111111111111
1000011111111111111111111
1000011111111111111111111
1000011111111111111111111
1000011111111111111111111
1000011111111111111111111
1000011111111111111111111
1000011111111111111111111
1000011111111111111111111
1000011111111111111111111
1000011111111111111111111
1000011111111111111111111
1000011111111111111111111
1111111111111111111111111
