NO ./maps/textures/north.png
SO ./maps/textures/south.png
WE ./maps/textures/west.png
EA ./maps/textures/east.png

FT ./maps/textures/floor.png
CT ./maps/textures/sky.png

F 220,100,0
C 225,30,0

111111111
111000111
100000001
111000111
100000001
111000111
111000111
100000001
111000111
100000001
100000001
100000001
100000001
100000001
100000001
100000001
100000001
100000001
100000001
100000001
111000111
100000001
111000111
100000001
100000001
100000001
100000001
100000001
111000111
100000001
111000111
100000001
111000111
100000001
100000001
100000001
100000001
100000001
100000001
100000001
111000111
100000001
111000111
100000001
100000001
100000001
100000001
100000001
100000001
111000111
100000001
111000111
100000001
111000111
100000001
100000001
100000001
100000001
100000001
100000001
100000001
111000111
100000001
111000111
111000111
100000001
100000001
100000001
100000001
100000001
100000001
100000001
111000111
100000001
111000111
100000001
111000111
100000001
111000111
100000001
111000111
100000001
100000001
10000N001
111111111