NO ./maps/textures/north.png
SO ./maps/textures/south.png
WE ./maps/textures/west.png
EA ./maps/textures/east.png

F 220,100,0
C 225,30,0

111111111
100000001
100011111
1000D0001
1N0011111
111111111