NO ./maps/textures/north.png
SO ./maps/textures/south.png
WE ./maps/textures/west.png
EA ./maps/textures/east.png

FT ./maps/textures/floor.png
CT ./maps/textures/sky.png

F 220,100,0
C 225,30,0

11111111111111111111111111
11111000111111111111111111
11111000111111111111111111
11111000111111111111111111
11111000111111111111111111
11111000111111111111111111
11111000111111111111111111
11111000111111111111111111
11111000111111111111111111
11111000111111111111111111
11111000111111111111111111
11111000111111111111111111
11111000111111111111111111
11111000111111111111111111
11111000111111111111111111
11111000111111111111111111
11111000111111111111111111
11111000111111111111111111
11111000111111111111111111
11111000111111111111111111
11111000000000000000000001
11111111111111111111100011
10001111111111111111100001
10001111111111111111100001
10001111111111111111100001
10001111111111111111100001
10001111111111111111100001
10001111111111111111100001
10001111111111111111100001
10001111111111111111100001
10001111111111111111100001
10001111111111111111100001
10001111111111111111100001
10001111111111111111100001
10001111111111111111100001
10001111111111111111100001
10001111111111111111100001
10001111111111111111100001
10001111111111111111100001
10001111111111111111100001
10001111111111111111100001
10001111111111111111100001
1000D000000000000000000001
10001111111111111111100001
10N01111111111111111111111
11111111111111111111111111