NO ./maps/textures/north.png
SO ./maps/textures/south.png
WE ./maps/textures/west.png
EA ./maps/textures/east.png
SP F ./maps/textures/fire.png 8 1
SP G ./maps/textures/dwarf_attack.png 11 2
SP C ./maps/textures/tocha.png 1 3

F 50,50,50
C 135,206,235

1111111111111111
1000000000000001
1000F00000G00001
1000000000000001
1000000CC0000001
1000000CC0000001
1000G00000F00001
1000000000000001
10000000N0000001
1111111111111111
